|------------------|
| 8                |
|     3 6          |
|   7     9   2    |
|   5       7      |
|         4 5 7    |
|       1       3  |
|     1         6 8|
|     8 5       1  |
|   9         4    |
|------------------|
|------------------|
|                 6|
| 7           4 9 8|
|   5       6   7  |
|         4     3  |
| 4   5            |
| 3     7   5 8 1  |
| 6         8     3|
|   3         2    |
|       2 9     8  |
|------------------|
|------------------|
|     5 3          |
| 8             2  |
|   7     1   5    |
| 4         5 3    |
|   1     7       6|
|     3 2       8  |
|   6   5         9|
|               3  |
|           9 7    |
|------------------|