|------------------|
|         8 3 9    |
| 1             3  |
|     4         7  |
|   4 2   3        |
| 6               4|
|         7     1  |
|   2              |
|   8       9 2    |
|       2 5       6|
|------------------|
|------------------|
|     8     4     5|
|       1   2      |
|     3         1  |
|   1              |
|         5   7    |
|   2       8      |
|     6       8    |
|       6       3  |
|         7   4 5  |
|------------------|
|------------------|
|   2       8     7|
|               6 1|
|         9        |
|       6          |
|       1 7       3|
|   5         2    |
|               5  |
| 6     3     4    |
|     1   4   7    |
|------------------|
|------------------|
|           2   5  |
| 7 6           9  |
|     5           1|
|   9       5      |
|   7         4    |
|       1       8  |
| 8           9    |
| 2 3     5     6  |
|   4   6   1      |
|------------------|
|------------------|
|   7 6       4    |
| 2     1 9        |
|               8  |
|     4   3     6  |
| 9       5   2    |
|               1  |
|     3           5|
|           8     7|
|       7          |
|------------------|
|------------------|
|     5         6  |
| 4       3        |
|   3   7     9    |
| 6     9          |
|     3         2 1|
|   8             5|
|     1 8          |
|         4 1      |
|   7         2    |
|------------------|
|------------------|
|     3       5    |
|   5   2     8    |
| 9       1     2  |
|     8           4|
|   3       4      |
|       9       7  |
|         5     9  |
|           8 4 6  |
| 1         3      |
|------------------|
|------------------|
| 1     3 4     9  |
|     8       7 6  |
| 2                |
|           8   1  |
| 3           4   7|
|       5          |
|   5              |
|         8   2    |
|     2   6   9   1|
|------------------|
|------------------|
| 8             3  |
|     1     4      |
|       7         5|
|     7   1        |
| 5 6   3          |
|         5 2   9  |
|                  |
| 3           6   7|
|     4       1    |
|------------------|
|------------------|
| 4     5     1    |
|           7      |
|     8 3         4|
|           2     3|
|   7           2  |
|     6 8     4    |
|   1       3      |
|       9          |
|   2         8 4 7|
|------------------|