|------------------|
|                  |
|           3  8  5|
|     1   2        |
|       5   7      |
|     4       1    |
|   9              |
| 5            7  3|
|    2   1         |
|        4        9|
|------------------|